
..O.......
E......E..
..........
..........
.......P..
..........
....E.....
..........
....EE....
..........