
EO........
..........
..........
E.........
.....E....
......E...
..........
.......E..
..........
.P........